2 1
34 30
6
2 1 6 1 6 10 2 10
10 16 12 18 10 20 8 18
4 28 24 28 24 32 4 32
27 16 29 16 29 25 27 25
34 16 36 16 36 30 34 30
16 36 18 36 18 38 16 38
32 34 34 36 32 38 30 36
